price_dec	好的，为您推荐一款便宜点的电脑
price_dec	我们为您推荐一款更便宜的电脑
price_dec_failed	这个配置没有更便宜的电脑了
price_dec_failed	对不起，这个配置没有更便宜的电脑了
brand_no	好的，不再为您推荐 <brand> 电脑
brand_no	好的，不再为您推荐 <brand> 牌的笔记本电脑
brand_assign	好的，下面只为您推荐 <brand> 牌的笔记本电脑

color_no	好的，不再为您推荐<color>色的电脑
color_assign	好的，下面只为您推荐<color>色的笔记本电脑
to_ask_color	请问您喜欢什么颜色的电脑
ask_color	这个电脑有<colors>的配色

ask_purpose	请问您一般用电脑做什么呢？
demand_level	根据您的使用场景，给您推荐 <level> 配置的电脑
demand_failed	当前条件下没有符合您需求的电脑了
portable	为您推荐便携的电脑
protable_failed	当前条件下没有便携的电脑
long_battery_life	为您推荐续航时间长的电脑
long_battery_life_failed	当前条件下没有续航时间长的电脑了

config_change	好的，为您推荐<item_change>的电脑
config_change_failed	对不起，当前配置下没有<item_change>的电脑了

rollback	好的，给您看刚才的电脑
rollback	好的，给您看刚才那台电脑

dont_know	对不起，能换个说法吗
dont_know	我没有理解，能换个说法吗

price_limit_failed	对不起，当前条件下没有价格低于<price>的电脑了
price_limit	好的，为您推荐<price>元以下的电脑
price_limit_cancle	好的，已经取消了价格限制

property_limit_cancle	好的，不限制<property>
property_limit_cancle_failed	当前配置找不到满足您要求的电脑
